                       w
                      TT
                      NN
   w           /---  -----\
  [--H--\      ####  ######-]''
   # H###-----\                    _    -
     H#########-\             /-------- #
f    H###########H~~~~~~~~~~~~#########w#
------###########H            ###########
#################H            ###########
#########################################
#########################################
#########################################
#########################################
#########################################
