

    g          -
  [--H--\      #
   # H###----- #
     H##########
f    H##########
------##########
################
################
################
################
################
################