



                      /---\    ---
                    [-#####----###
       /-\     /--]  #############
    /--###-----###   #############
   /##############################
---###############################
##################################
##################################
##################################
##################################
##################################