



                    /---\    ---
                  [-#####----###
     /-\     /--]  #############
  /--###-----###   #############
 /##############################
-###############################
################################
################################
################################
################################
################################