


                 [----
              ########
         \  # ########
     /---#############
    /#################
----##################
######################
######################
######################
######################
######################