


----\  /-----
#####--######
#############
#############
#############
#############
#############
#############
#############
#############