


                      --
       w   P   /--\   ##
---------------####---##
########################
########################
########################
########################
########################