


                  >     --
t        w   P   /--\   ##
-----------------####---##
##########################
##########################
##########################
##########################
##########################