

?
?                 >     --
t        w   P   /--\   ##
-----------------####---##
##########################
##########################
##########################
##########################
##########################