

                         i
           ---\      ---------
     -----/####-----/#########
----/#########################
##############################
##############################
##############################
##############################
##############################