             #     ######
             #    #######
             #"H" #######
             # H  #######
             # H   ######
             ###'  ######